[TILE_SET]
#id	filePath	num_rows	num_cols
1	resources/lv0/textures/tileset-lv0.png	1	23
[MAP_MATRIX]
1,2,2,2,2,2,1,1,1,2,2,2,2,2,1,1,1,1,1,1,3,4,4,5,
6,6,6,6,6,6,2,2,6,6,6,6,6,6,2,2,2,2,2,2,7,8,8,9,
6,10,6,6,6,6,6,6,6,10,6,6,6,6,6,6,6,6,10,10,11,12,8,5,
10,13,10,10,10,10,10,10,10,13,10,10,10,10,10,10,10,10,13,14,11,5,8,9,
15,16,17,15,15,17,15,17,15,16,17,15,15,17,15,17,17,18,16,19,20,21,22,9,
23,23,23,23,23,23,23,23,23,23,23,23,23,23,23,23,23,23,23,23,23,23,23,23