[TILE_SET]
#id	filePath	num_rows	num_cols
0	resources/lv2/tile-set-lv2.png	2	7
[MAP_MATRIX]
1,2,3,3,4,5,2,6
1,2,3,4,3,7,2,6
6,8,9,10,11,3,2,6
6,2,7,3,3,12,8,6
13,2,3,3,4,3,5,6
14,8,10,9,11,11,10,6