[TILE_SET]
#id	filePath	num_rows	num_cols
1	resources/lv3/tile-set-lv3.png	2	7
[MAP_MATRIX]
1,2,3,4,5,3,2,5,4,5,2,4,5,5,2,6
7,3,5,4,8,2,5,5,4,2,5,4,8,2,5,6
9,5,2,10,11,5,12,12,10,3,5,10,11,12,5,6
1,5,11,4,6,5,5,6,1,12,8,6,3,8,13,6
1,2,3,4,6,5,2,6,1,5,11,6,5,14,4,6
1,8,5,4,6,5,5,6,1,5,5,5,14,5,4,6